날짜,스크린수,스크린점유율,상영횟수,상영점유율,좌석수,좌석점유율,좌석판매율,매출액,매출액증감(전일대비),관객수,관객수증감(전일대비),누적매출액,누적관객수,순위
2018-10-24,5,0.1%,6,0%,1361,0.1%,92.1%,11039000,11039000 ( 100.0% ),1254,1254 ( 100.0% ),11039000,1254,16
2018-10-25,4,0.1%,4,0%,1119,0.0%,100.0%,10071000,-968000 ( -8.8% ),1119,-135 ( -10.8% ),21110000,2373,12
2018-10-26,1,0.0%,1,0%,174,0.0%,100.0%,1566000,-8505000 ( -84.5% ),174,-945 ( -84.5% ),22676000,2547,34
2018-10-29,43,0.8%,43,0.3%,7516,0.3%,92.1%,48171000,48171000 ( 100.0% ),6919,6919 ( 100.0% ),70847000,9466,9
2018-10-30,3,0.1%,4,0%,686,0.0%,80.9%,4095000,-44076000 ( -91.5% ),555,-6364 ( -92.0% ),74942000,10021,18
2018-10-31,811,13.6%,2937,16.2%,497769,17.5%,22.2%,760190950,756095950 ( 18463.9% ),110477,109922 ( 19805.8% ),835132950,120498,2
2018-11-01,777,13.5%,3018,17.2%,527329,19.0%,12.4%,565879350,-194311600 ( -25.6% ),65472,-45005 ( -40.7% ),1401012300,185970,2
2018-11-02,838,14.2%,3227,17.8%,564020,19.7%,17.7%,948085902,382206552 ( 67.5% ),99555,34083 ( 52.1% ),2349098202,285525,2
2018-11-03,910,14.5%,3602,18.9%,613373,20.5%,35.9%,2083926361,1135840459 ( 119.8% ),219900,120345 ( 120.9% ),4433024563,505425,2
2018-11-04,936,15.1%,3662,19.7%,626963,21.5%,32.5%,1902230050,-181696311 ( -8.7% ),203898,-16002 ( -7.3% ),6335254613,709323,2
2018-11-05,882,16.2%,3584,21.3%,621820,23.2%,12.9%,685354050,-1216876000 ( -64.0% ),80136,-123762 ( -60.7% ),7020608663,789459,2
2018-11-06,898,16.2%,3631,21.7%,628457,23.5%,13.5%,723283150,37929100 ( 5.5% ),85040,4904 ( 6.1% ),7743891813,874499,2
2018-11-07,874,16.9%,3477,20.1%,596490,21.7%,15.1%,766841400,43558250 ( 6.0% ),89874,4834 ( 5.7% ),8510733213,964373,2
2018-11-08,891,15.9%,3383,19.5%,581043,21.1%,16.3%,806737250,39895850 ( 5.2% ),94697,4823 ( 5.4% ),9317470463,1059070,2
2018-11-09,960,16.8%,3725,20.8%,633476,22.3%,23.7%,1401045537,594308287 ( 73.7% ),150117,55420 ( 58.5% ),10718516000,1209187,2
2018-11-10,1040,17.3%,4312,22.7%,721578,24.2%,44.7%,2998080301,1597034764 ( 114.0% ),322326,172209 ( 114.7% ),13716596301,1531513,2
2018-11-11,1098,18.1%,4383,23.5%,730381,25.0%,42.7%,2871375300,-126705001 ( -4.2% ),311652,-10674 ( -3.3% ),16587971601,1843165,2
2018-11-12,1002,19.4%,4195,24.9%,717646,26.7%,15.2%,930124000,-1941251300 ( -67.6% ),109370,-202282 ( -64.9% ),17518095601,1952535,2
2018-11-13,1018,19.0%,4235,25.1%,717606,26.7%,16.6%,1002547950,72423950 ( 7.8% ),119031,9661 ( 8.8% ),18520643551,2071566,1
2018-11-14,735,15.5%,2812,16.5%,400892,15.0%,29.7%,970597550,-31950400 ( -3.2% ),119169,138 ( 0.1% ),19491241101,2190735,2
2018-11-15,807,14.3%,2595,14.9%,368399,13.4%,35.6%,1037072950,66475400 ( 6.8% ),131138,11969 ( 10.0% ),20528314051,2321873,2
2018-11-16,888,16.0%,3054,17.4%,446681,16.2%,38.2%,1523160660,486087710 ( 46.9% ),170462,39324 ( 30.0% ),22051474711,2492335,2
2018-11-17,1105,18.0%,3818,20.8%,569900,19.8%,57.3%,2950351360,1427190700 ( 93.7% ),326368,155906 ( 91.5% ),25001826071,2818703,2
2018-11-18,1179,19.2%,4057,22.7%,610200,21.8%,52.3%,2865565300,-84786060 ( -2.9% ),319315,-7053 ( -2.2% ),27867391371,3138018,2
2018-11-19,1048,20.2%,4137,25.1%,666823,25.7%,20.3%,1103435350,-1762129950 ( -61.5% ),135596,-183719 ( -57.5% ),28970826721,3273614,1
2018-11-20,1109,20.2%,4289,26%,700394,26.9%,18.6%,1053530350,-49905000 ( -4.5% ),130475,-5121 ( -3.8% ),30024357071,3404089,1
2018-11-21,1164,22.2%,4866,29.6%,848788,32.8%,18.1%,1227310550,173780200 ( 16.5% ),153271,22796 ( 17.5% ),31251667621,3557360,1
2018-11-22,1026,18.9%,4061,23.7%,729360,27.0%,18.1%,1071685650,-155624900 ( -12.7% ),131665,-21606 ( -14.1% ),32323353271,3689025,2
2018-11-23,1054,19.1%,4344,24.6%,787804,28.3%,24.1%,1699394218,627708568 ( 58.6% ),189644,57979 ( 44.0% ),34022747489,3878669,1
2018-11-24,1136,19.6%,5013,27%,912371,31.4%,43.3%,3612363296,1912969078 ( 112.6% ),395504,205860 ( 108.6% ),37635110785,4274173,1
2018-11-25,1121,19.5%,4946,27.2%,901665,31.7%,41.1%,3331716050,-280647246 ( -7.8% ),370278,-25226 ( -6.4% ),40966826835,4644451,1
2018-11-26,1062,20.7%,4594,27.3%,841989,31.6%,16.1%,1096676600,-2235039450 ( -67.1% ),135951,-234327 ( -63.3% ),42063503435,4780402,1
2018-11-27,1119,20.4%,4365,26.8%,798179,31.0%,16.5%,1048715350,-47961250 ( -4.4% ),131835,-4116 ( -3.0% ),43112218785,4912237,1
2018-11-28,928,16.1%,3408,19.2%,585833,20.8%,34.6%,1306567050,257851700 ( 24.6% ),202908,71073 ( 53.9% ),44418785835,5115145,2
2018-11-29,896,15.7%,3423,19.2%,592140,21.0%,21.5%,1020031800,-286535250 ( -21.9% ),127482,-75426 ( -37.2% ),45438817635,5242627,2
2018-11-30,998,17.1%,3861,21.2%,660094,22.9%,27.9%,1614687854,594656054 ( 58.3% ),184033,56551 ( 44.4% ),47053505489,5426660,2
2018-12-01,1093,18.1%,4725,25%,809564,27.2%,40.5%,2996655884,1381968030 ( 85.6% ),328050,144017 ( 78.3% ),50050161373,5754710,2
2018-12-02,1103,18.4%,4706,25.3%,805542,27.6%,36.3%,2642813900,-353841984 ( -11.8% ),292238,-35812 ( -10.9% ),52692975273,6046948,2
2018-12-03,1033,18.9%,4348,25%,756931,27.4%,14.8%,905280650,-1737533250 ( -65.7% ),111720,-180518 ( -61.8% ),53598255923,6158668,2
2018-12-04,1060,18.5%,4366,25%,756099,27.3%,15.1%,911587800,6307150 ( 0.7% ),114000,2280 ( 2.0% ),54509843723,6272668,2
2018-12-05,845,15.8%,3398,18.9%,585758,20.6%,16.4%,782250700,-129337100 ( -14.2% ),96185,-17815 ( -15.6% ),55292094423,6368853,3
2018-12-06,832,13.7%,3148,17.2%,544542,18.9%,17.3%,756668450,-25582250 ( -3.3% ),94068,-2117 ( -2.2% ),56048762873,6462921,3
2018-12-07,891,14.5%,3295,17.6%,560930,19.0%,21.8%,1095328773,338660323 ( 44.8% ),122108,28040 ( 29.8% ),57144091646,6585029,3
2018-12-08,953,14.7%,3735,18.8%,633369,20.3%,39.6%,2283092918,1187764145 ( 108.4% ),250812,128704 ( 105.4% ),59427184564,6835841,2
2018-12-09,965,14.9%,3726,19%,633258,20.6%,35.4%,2029782750,-253310168 ( -11.1% ),224342,-26470 ( -10.6% ),61456967314,7060183,2
2018-12-10,914,15.1%,3472,19.5%,597721,21.1%,13.1%,627936850,-1401845900 ( -69.1% ),78044,-146298 ( -65.2% ),62084904164,7138227,2
2018-12-11,934,14.8%,3485,19.4%,593394,20.9%,14.1%,663764850,35828000 ( 5.7% ),83529,5485 ( 7.0% ),62748669014,7221756,2
2018-12-12,845,14.2%,3082,17.1%,541402,18.9%,15.3%,660970450,-2794400 ( -0.4% ),82993,-536 ( -0.6% ),63409639464,7304749,2
2018-12-13,844,13.2%,3074,17.1%,543879,19.1%,15.4%,670375450,9405000 ( 1.4% ),83962,969 ( 1.2% ),64080014914,7388711,2
2018-12-14,917,13.3%,3299,17.8%,572260,19.6%,19.9%,1005999400,335623950 ( 50.1% ),114156,30194 ( 36.0% ),65086014314,7502867,1
2018-12-15,1004,13.6%,3678,18.6%,646217,20.9%,35.1%,2046307000,1040307600 ( 103.4% ),227048,112892 ( 98.9% ),67132321314,7729915,1
2018-12-16,979,13.5%,3632,18.8%,639564,21.1%,33.2%,1908219500,-138087500 ( -6.7% ),212584,-14464 ( -6.4% ),69040540814,7942499,1
2018-12-17,938,15.5%,3588,20.4%,637701,22.9%,12.4%,633497200,-1274722300 ( -66.8% ),79174,-133410 ( -62.8% ),69674038014,8021673,1
2018-12-18,972,14.9%,3610,20.3%,634494,22.6%,13.7%,687395500,53898300 ( 8.5% ),86685,7511 ( 9.5% ),70361433514,8108358,1
2018-12-19,546,8.6%,1118,6.5%,154037,5.7%,28.3%,345263450,-342132050 ( -49.8% ),43581,-43104 ( -49.7% ),70706696964,8151939,4
2018-12-20,567,8.8%,1165,6.8%,157883,5.9%,28.1%,355543850,10280400 ( 3.0% ),44439,858 ( 2.0% ),71062240814,8196378,4
2018-12-21,635,9.7%,1374,7.8%,188586,6.8%,31.2%,518592750,163048900 ( 45.9% ),58848,14409 ( 32.4% ),71580833564,8255226,4
2018-12-22,713,10.3%,1646,8.7%,228496,7.8%,51.9%,1083716600,565123850 ( 109.0% ),118557,59709 ( 101.5% ),72664550164,8373783,4
2018-12-23,747,10.7%,1769,9.4%,249651,8.5%,51.4%,1165962200,82245600 ( 7.6% ),128343,9786 ( 8.3% ),73830512364,8502126,4
2018-12-24,784,10.6%,1784,9.3%,248647,8.3%,48.2%,974195300,-191766900 ( -16.4% ),119923,-8420 ( -6.6% ),74804707664,8622049,3
2018-12-25,687,9.3%,1545,7.7%,217166,6.9%,66.3%,1295938800,321743500 ( 33.0% ),143949,24026 ( 20.0% ),76100646464,8765998,6
2018-12-26,551,8.3%,1135,6.1%,152070,5.2%,35.3%,373959650,-921979150 ( -71.1% ),53678,-90271 ( -62.7% ),76474606114,8819676,5
2018-12-27,595,8.9%,1259,6.8%,176543,6.1%,23.9%,344282000,-29677650 ( -7.9% ),42277,-11401 ( -21.2% ),76818888114,8861953,4
2018-12-28,636,9.2%,1411,7.5%,194850,6.6%,26.9%,475833308,131551308 ( 38.2% ),52379,10102 ( 23.9% ),77294721422,8914332,4
2018-12-29,675,9.2%,1538,7.8%,218143,7.1%,43.9%,874750873,398917565 ( 83.8% ),95696,43317 ( 82.7% ),78169472295,9010028,4
2018-12-30,674,9.3%,1594,8.2%,225892,7.5%,47.9%,982429250,107678377 ( 12.3% ),108106,12410 ( 13.0% ),79151901545,9118134,4
2018-12-31,684,9.9%,1760,9.1%,251890,8.4%,42.3%,858538800,-123890450 ( -12.6% ),106448,-1658 ( -1.5% ),80010440345,9224582,4
2019-01-01,732,10.2%,1872,9.6%,276693,9.2%,49.1%,1236738450,378199650 ( 44.1% ),135879,29431 ( 27.6% ),81247178795,9360461,3
2019-01-02,693,10.2%,1836,10%,276768,9.7%,14.8%,330326950,-906411500 ( -73.3% ),40954,-94925 ( -69.9% ),81577505745,9401415,3
2019-01-03,652,9.3%,1711,9.3%,262074,9.1%,12.5%,267494700,-62832250 ( -19.0% ),32889,-8065 ( -19.7% ),81845000445,9434304,4
2019-01-04,657,9.4%,1828,9.7%,281443,9.6%,13.7%,351188900,83694200 ( 31.3% ),38528,5639 ( 17.1% ),82196189345,9472832,3
2019-01-05,708,9.1%,1828,9.4%,279070,9.2%,26.7%,683046150,331857250 ( 94.5% ),74552,36024 ( 93.5% ),82879235495,9547384,3
2019-01-06,701,9.0%,1788,9.4%,274699,9.3%,22.9%,570969800,-112076350 ( -16.4% ),63005,-11547 ( -15.5% ),83450205295,9610389,3
2019-01-07,635,9.4%,1803,10.2%,275630,10.0%,9.5%,213124500,-357845300 ( -62.7% ),26315,-36690 ( -58.2% ),83663329795,9636704,3
2019-01-08,653,9.4%,1807,10.2%,276481,10.0%,10.3%,229529100,16404600 ( 7.7% ),28415,2100 ( 8.0% ),83892858895,9665119,3
2019-01-09,517,8.5%,1135,6.4%,161152,5.8%,11.8%,155566300,-73962800 ( -32.2% ),18969,-9446 ( -33.2% ),84048425195,9684088,5
2019-01-10,511,7.6%,995,5.4%,142641,5.0%,12.0%,141139500,-14426800 ( -9.3% ),17054,-1915 ( -10.1% ),84189564695,9701142,6
2019-01-11,521,7.6%,974,5.2%,140945,4.8%,13.8%,178498150,37358650 ( 26.5% ),19441,2387 ( 14.0% ),84368062845,9720583,6
2019-01-12,502,7.1%,930,4.7%,125858,4.1%,27.9%,325379510,146881360 ( 82.3% ),35064,15623 ( 80.4% ),84693442355,9755647,6
2019-01-13,504,7.2%,911,4.8%,124983,4.2%,24.0%,277610030,-47769480 ( -14.7% ),30032,-5032 ( -14.4% ),84971052385,9785679,6
2019-01-14,490,7.7%,931,5.2%,130830,4.7%,9.6%,102923270,-174686760 ( -62.9% ),12508,-17524 ( -58.4% ),85073975655,9798187,5
2019-01-15,505,7.7%,950,5.3%,134345,4.8%,10.0%,110978000,8054730 ( 7.8% ),13438,930 ( 7.4% ),85184953655,9811625,5
2019-01-16,324,4.6%,554,3.1%,79004,2.8%,11.8%,77700940,-33277060 ( -30.0% ),9316,-4122 ( -30.7% ),85262654595,9820941,9
2019-01-17,241,3.3%,332,1.8%,44893,1.6%,15.5%,56880690,-20820250 ( -26.8% ),6954,-2362 ( -25.4% ),85319535285,9827895,10
2019-01-18,272,3.7%,379,2.1%,51347,1.8%,16.6%,77849680,20968990 ( 36.9% ),8529,1575 ( 22.6% ),85397384965,9836424,8
2019-01-19,285,3.7%,446,2.3%,58733,1.9%,27.5%,150645160,72795480 ( 93.5% ),16174,7645 ( 89.6% ),85548030125,9852598,9
2019-01-20,291,3.8%,444,2.3%,59188,2.0%,24.0%,130942330,-19702830 ( -13.1% ),14212,-1962 ( -12.1% ),85678972455,9866810,9
2019-01-21,304,4.4%,532,3.1%,75218,2.8%,9.9%,52915610,-78026720 ( -59.6% ),7459,-6753 ( -47.5% ),85731888065,9874269,6
2019-01-22,324,4.5%,555,3.2%,78753,2.9%,10.6%,59121340,6205730 ( 11.7% ),8363,904 ( 12.1% ),85791009405,9882632,6
2019-01-23,228,3.7%,342,1.9%,44299,1.5%,11.4%,35812660,-23308680 ( -39.4% ),5036,-3327 ( -39.8% ),85826822065,9887668,7
2019-01-24,218,3.5%,305,1.7%,40342,1.4%,14.6%,40614490,4801830 ( 13.4% ),5890,854 ( 17.0% ),85867436555,9893558,6
2019-01-25,212,3.4%,305,1.6%,39422,1.3%,12.8%,36732850,-3881640 ( -9.6% ),5062,-828 ( -14.1% ),85904169405,9898620,7
2019-01-26,186,2.8%,264,1.3%,33166,1.1%,19.9%,49658570,12925720 ( 35.2% ),6607,1545 ( 30.5% ),85953827975,9905227,11
2019-01-27,186,2.9%,255,1.3%,32508,1.1%,16.9%,40955850,-8702720 ( -17.5% ),5479,-1128 ( -17.1% ),85994783825,9910706,12
2019-01-28,200,3.4%,291,1.6%,37745,1.3%,10.9%,27783180,-13172670 ( -32.2% ),4122,-1357 ( -24.8% ),86022567005,9914828,8
2019-01-29,207,3.4%,300,1.6%,39686,1.4%,14.3%,36896940,9113760 ( 32.8% ),5666,1544 ( 37.5% ),86059463945,9920494,6
2019-01-30,46,0.9%,54,0.3%,7665,0.3%,15.7%,8659700,-28237240 ( -76.5% ),1206,-4460 ( -78.7% ),86068123645,9921700,13
2019-01-31,39,0.7%,47,0.2%,7007,0.2%,15.1%,7365300,-1294400 ( -14.9% ),1056,-150 ( -12.4% ),86075488945,9922756,15
2019-02-01,40,0.7%,44,0.2%,6924,0.2%,18.0%,10601550,3236250 ( 43.9% ),1243,187 ( 17.7% ),86086090495,9923999,11
2019-02-02,34,0.6%,39,0.2%,6449,0.2%,25.7%,14146450,3544900 ( 33.4% ),1658,415 ( 33.4% ),86100236945,9925657,13
2019-02-03,35,0.6%,43,0.2%,7243,0.2%,24.2%,13661860,-484590 ( -3.4% ),1756,98 ( 5.9% ),86113898805,9927413,12
2019-02-04,44,0.8%,51,0.2%,8296,0.3%,24.3%,15782600,2120740 ( 15.5% ),2016,260 ( 14.8% ),86129681405,9929429,9
2019-02-05,32,0.6%,36,0.2%,5900,0.2%,26.8%,12483100,-3299500 ( -20.9% ),1581,-435 ( -21.6% ),86142164505,9931010,10
2019-02-06,34,0.6%,37,0.2%,5380,0.2%,28.3%,11720800,-762300 ( -6.1% ),1524,-57 ( -3.6% ),86153885305,9932534,11
2019-02-07,25,0.4%,27,0.1%,4326,0.1%,19.0%,6366100,-5354700 ( -45.7% ),820,-704 ( -46.2% ),86160251405,9933354,15
2019-02-08,28,0.5%,30,0.2%,4898,0.2%,15.7%,6563100,197000 ( 3.1% ),768,-52 ( -6.3% ),86166814505,9934122,16
2019-02-09,24,0.4%,28,0.1%,4261,0.1%,22.7%,7986050,1422950 ( 21.7% ),967,199 ( 25.9% ),86174800555,9935089,15
2019-02-10,19,0.3%,25,0.1%,3824,0.1%,14.0%,3999600,-3986450 ( -49.9% ),536,-431 ( -44.6% ),86178800155,9935625,16
2019-02-11,25,0.5%,31,0.2%,4129,0.1%,9.7%,3184500,-815100 ( -20.4% ),399,-137 ( -25.6% ),86181984655,9936024,15
2019-02-12,20,0.4%,26,0.1%,3573,0.1%,10.2%,2680750,-503750 ( -15.8% ),363,-36 ( -9.0% ),86184665405,9936387,21
2019-02-13,10,0.2%,12,0.1%,1605,0.1%,15.9%,1990800,-689950 ( -25.7% ),255,-108 ( -29.8% ),86186656205,9936642,31
2019-02-14,5,0.1%,5,0%,717,0.0%,15.6%,895000,-1095800 ( -55.0% ),112,-143 ( -56.1% ),86187551205,9936754,47
2019-02-15,13,0.2%,13,0.1%,2075,0.1%,17.5%,3366000,2471000 ( 276.1% ),364,252 ( 225.0% ),86190917205,9937118,23
2019-02-16,11,0.2%,11,0.1%,2560,0.1%,22.9%,5249600,1883600 ( 56.0% ),586,222 ( 61.0% ),86196166805,9937704,22
2019-02-17,4,0.1%,4,0%,568,0.0%,41.7%,2227800,-3021800 ( -57.6% ),237,-349 ( -59.6% ),86198394605,9937941,27
2019-02-18,4,0.1%,4,0%,877,0.0%,7.1%,431500,-1796300 ( -80.6% ),62,-175 ( -73.8% ),86198826105,9938003,42
2019-02-19,5,0.1%,5,0%,681,0.0%,18.4%,998480,566980 ( 131.4% ),125,63 ( 101.6% ),86199824585,9938128,40
2019-02-20,3,0.0%,4,0%,556,0.0%,11.5%,448500,-549980 ( -55.1% ),64,-61 ( -48.8% ),86200273085,9938192,48
2019-02-21,7,0.1%,7,0%,1555,0.1%,39.7%,6241500,5793000 ( 1291.6% ),618,554 ( 865.6% ),86206514585,9938810,24
2019-02-22,9,0.1%,9,0%,1734,0.1%,12.5%,1987500,-4254000 ( -68.2% ),216,-402 ( -65.0% ),86208502085,9939026,30
2019-02-23,8,0.1%,8,0%,1372,0.0%,24.9%,3225300,1237800 ( 62.3% ),342,126 ( 58.3% ),86211727385,9939368,30
2019-02-24,2,0.0%,2,0%,235,0.0%,31.1%,567300,-2658000 ( -82.4% ),73,-269 ( -78.7% ),86212294685,9939441,54
2019-02-25,2,0.0%,2,0%,296,0.0%,13.5%,281000,-286300 ( -50.5% ),40,-33 ( -45.2% ),86212575685,9939481,58
2019-02-26,6,0.1%,6,0%,679,0.0%,27.8%,1373100,1092100 ( 388.6% ),189,149 ( 372.5% ),86213948785,9939670,46
2019-02-27,3,0.0%,3,0%,527,0.0%,23.7%,890800,-482300 ( -35.1% ),125,-64 ( -33.9% ),86214839585,9939795,51
2019-02-28,5,0.1%,5,0%,399,0.0%,25.1%,794600,-96200 ( -10.8% ),100,-25 ( -20.0% ),86215634185,9939895,54
2019-03-01,24,0.3%,30,0.1%,5289,0.2%,14.6%,6826910,6032310 ( 759.2% ),773,673 ( 673.0% ),86222461095,9940668,23
2019-03-02,27,0.4%,33,0.2%,4734,0.2%,13.9%,6057260,-769650 ( -11.3% ),657,-116 ( -15.0% ),86228518355,9941325,22
2019-03-03,27,0.4%,33,0.2%,5385,0.2%,8.8%,4144250,-1913010 ( -31.6% ),475,-182 ( -27.7% ),86232662605,9941800,25
2019-03-04,32,0.5%,36,0.2%,5615,0.2%,8.3%,3214000,-930250 ( -22.4% ),466,-9 ( -1.9% ),86235876605,9942266,18
2019-03-05,28,0.5%,34,0.2%,6016,0.2%,3.8%,1853500,-1360500 ( -42.3% ),228,-238 ( -51.1% ),86237730105,9942494,25
2019-03-06,15,0.3%,16,0.1%,2345,0.1%,8.1%,1278300,-575200 ( -31.0% ),189,-39 ( -17.1% ),86239008405,9942683,22
2019-03-07,15,0.3%,15,0.1%,2918,0.1%,8.1%,1471500,193200 ( 15.1% ),236,47 ( 24.9% ),86240479905,9942919,26
2019-03-08,14,0.3%,14,0.1%,2074,0.1%,12.5%,1624000,152500 ( 10.4% ),259,23 ( 9.7% ),86242103905,9943178,21
2019-03-09,15,0.3%,15,0.1%,1919,0.1%,26.9%,3494300,1870300 ( 115.2% ),517,258 ( 99.6% ),86245598205,9943695,20
2019-03-10,15,0.3%,15,0.1%,2447,0.1%,13.8%,2392700,-1101600 ( -31.5% ),338,-179 ( -34.6% ),86247990905,9944033,22
2019-03-11,14,0.3%,15,0.1%,2165,0.1%,4.9%,716500,-1676200 ( -70.1% ),106,-232 ( -68.6% ),86248707405,9944139,29
2019-03-12,14,0.3%,15,0.1%,2104,0.1%,5.0%,702800,-13700 ( -1.9% ),106,0 ( 0.0% ),86249410205,9944245,33
2019-03-13,15,0.3%,15,0.1%,2887,0.1%,5.5%,1064000,361200 ( 51.4% ),160,54 ( 50.9% ),86250474205,9944405,28
2019-03-14,1,0.0%,1,0%,80,0.0%,10.0%,62300,-1001700 ( -94.1% ),8,-152 ( -95.0% ),86250536505,9944413,75
2019-03-15,2,0.0%,2,0%,921,0.0%,2.9%,205000,142700 ( 229.1% ),27,19 ( 237.5% ),86250741505,9944440,58
2019-03-16,2,0.0%,2,0%,876,0.0%,2.7%,167500,-37500 ( -18.3% ),24,-3 ( -11.1% ),86250909005,9944464,77
2019-03-17,1,0.0%,1,0%,35,0.0%,42.9%,140500,-27000 ( -16.1% ),15,-9 ( -37.5% ),86251049505,9944479,78
2019-03-18,4,0.1%,4,0%,1025,0.0%,5.0%,426480,285980 ( 203.5% ),51,36 ( 240.0% ),86251475985,9944530,41
2019-03-19,1,0.0%,1,0%,80,0.0%,10.0%,53500,-372980 ( -87.5% ),8,-43 ( -84.3% ),86251529485,9944538,80
2019-03-20,6,0.1%,6,0%,1444,0.1%,84.3%,10968000,10914500 ( 20400.9% ),1218,1210 ( 15125.0% ),86262497485,9945756,10
2019-03-21,3,0.1%,3,0%,898,0.0%,8.0%,652000,-10316000 ( -94.1% ),72,-1146 ( -94.1% ),86263149485,9945828,45
2019-03-22,2,0.0%,2,0%,195,0.0%,8.7%,165800,-486200 ( -74.6% ),17,-55 ( -76.4% ),86263315285,9945845,73
2019-03-23,2,0.0%,3,0%,192,0.0%,8.9%,158300,-7500 ( -4.5% ),17,0 ( 0.0% ),86263473585,9945862,92
2019-03-24,2,0.0%,3,0%,192,0.0%,20.8%,366500,208200 ( 131.5% ),40,23 ( 135.3% ),86263840085,9945902,71
2019-03-25,2,0.0%,3,0%,192,0.0%,9.4%,140300,-226200 ( -61.7% ),18,-22 ( -55.0% ),86263980385,9945920,69
2019-03-26,1,0.0%,2,0%,140,0.0%,6.4%,60800,-79500 ( -56.7% ),9,-9 ( -50.0% ),86264041185,9945929,87
2019-03-27,3,0.0%,3,0%,963,0.0%,3.6%,216000,155200 ( 255.3% ),35,26 ( 288.9% ),86264257185,9945964,78
2019-03-28,1,0.0%,2,0%,140,0.0%,2.9%,26500,-189500 ( -87.7% ),4,-31 ( -88.6% ),86264283685,9945968,98
2019-03-29,1,0.0%,1,0%,70,0.0%,14.3%,82100,55600 ( 209.8% ),10,6 ( 150.0% ),86264365785,9945978,83
2019-03-30,2,0.0%,2,0%,166,0.0%,84.3%,979000,896900 ( 1092.4% ),140,130 ( 1300.0% ),86265344785,9946118,45
2019-03-31,2,0.0%,2,0%,87,0.0%,16.1%,100000,-879000 ( -89.8% ),14,-126 ( -90.0% ),86265444785,9946132,78
2019-04-01,2,0.0%,2,0%,122,0.0%,15.6%,139900,39900 ( 39.9% ),19,5 ( 35.7% ),86265584685,9946151,70
2019-04-02,1,0.0%,1,0%,70,0.0%,2.9%,13000,-126900 ( -90.7% ),2,-17 ( -89.5% ),86265597685,9946153,91
2019-04-03,1,0.0%,1,0%,143,0.0%,6.3%,68000,55000 ( 423.1% ),9,7 ( 350.0% ),86265665685,9946162,77
2019-04-04,1,0.0%,1,0%,143,0.0%,4.2%,51500,-16500 ( -24.3% ),6,-3 ( -33.3% ),86265717185,9946168,82
2019-04-05,1,0.0%,1,0%,200,0.0%,5.0%,89300,37800 ( 73.4% ),10,4 ( 66.7% ),86265806485,9946178,84
2019-04-06,1,0.0%,1,0%,143,0.0%,4.9%,79300,-10000 ( -11.2% ),7,-3 ( -30.0% ),86265885785,9946185,91
2019-04-07,2,0.0%,2,0%,195,0.0%,6.7%,129000,49700 ( 62.7% ),13,6 ( 85.7% ),86266014785,9946198,83
2019-04-08,1,0.0%,2,0%,286,0.0%,3.8%,97500,-31500 ( -24.4% ),11,-2 ( -15.4% ),86266112285,9946209,70
2019-04-09,1,0.0%,2,0%,286,0.0%,3.5%,88100,-9400 ( -9.6% ),10,-1 ( -9.1% ),86266200385,9946219,83
2019-04-10,2,0.0%,2,0%,195,0.0%,5.1%,102000,13900 ( 15.8% ),10,0 ( 0.0% ),86266302385,9946229,79
2019-04-11,1,0.0%,1,0%,143,0.0%,4.2%,60000,-42000 ( -41.2% ),6,-4 ( -40.0% ),86266362385,9946235,89
2019-04-12,10,0.2%,10,0.1%,1807,0.1%,10.1%,1248000,1188000 ( 1980.0% ),182,176 ( 2933.3% ),86267610385,9946417,34
2019-04-13,12,0.2%,12,0.1%,1957,0.1%,13.2%,1789800,541800 ( 43.4% ),259,77 ( 42.3% ),86269400185,9946676,31
2019-04-14,13,0.2%,13,0.1%,2389,0.1%,10.8%,1758500,-31300 ( -1.7% ),258,-1 ( -0.4% ),86271158685,9946934,30
2019-04-15,11,0.2%,12,0.1%,2204,0.1%,5.4%,818000,-940500 ( -53.5% ),120,-138 ( -53.5% ),86271976685,9947054,39
2019-04-16,12,0.2%,12,0.1%,2075,0.1%,6.2%,847500,29500 ( 3.6% ),128,8 ( 6.7% ),86272824185,9947182,37
2019-04-17,13,0.2%,14,0.1%,2559,0.1%,9.1%,1562000,714500 ( 84.3% ),232,104 ( 81.3% ),86274386185,9947414,35
2019-04-18,11,0.2%,12,0.1%,2204,0.1%,5.4%,790000,-772000 ( -49.4% ),118,-114 ( -49.1% ),86275176185,9947532,54
2019-04-19,12,0.2%,12,0.1%,2018,0.1%,12.4%,1681500,891500 ( 112.8% ),251,133 ( 112.7% ),86276857685,9947783,42
2019-04-20,13,0.2%,13,0.1%,2332,0.1%,17.4%,2752500,1071000 ( 63.7% ),405,154 ( 61.4% ),86279610185,9948188,35
2019-04-21,11,0.1%,11,0.1%,1977,0.1%,9.4%,1266000,-1486500 ( -54.0% ),186,-219 ( -54.1% ),86280876185,9948374,42
2019-04-22,1,0.0%,1,0%,143,0.0%,3.5%,40300,-1225700 ( -96.8% ),5,-181 ( -97.3% ),86280916485,9948379,90
2019-04-23,1,0.0%,1,0%,143,0.0%,4.9%,59300,19000 ( 47.1% ),7,2 ( 40.0% ),86280975785,9948386,105
